##############################################|####################################################
###.....................###...............###..................................##.........###...###
#####################...###...#########...###.................................###...###...###...###
###.....................###.........###...###.................................###.........###...###
#########...#####################...###...###.................................###...#########...###
###...........................###...###...###...................................................###
###...........................###...###...###.................................###############...###
###...........................###...###...###.............................................###...###
###...........................###...###...###.............................................###...###
###...........................###...###...###.................................#########...###...###
###...........................###...###...###.......................................###...###...###
###...........................###...#########.................................###...###...###...###
###...........................###.............................................###...###...###...###
###...........................###...###################################################...###...###
###...........................###.........................................................###...###
###...........................###...#########################################################...###
###...........................###...###....EXIT...........................................###...###
###...........................###...###...............###.................................###...###
###...#####################...###...###...............###.................................###...###
###.....................###.........###...............###.................................###...###
###...###############...###.........###...............###.................................###...###
###...###...............###.........###...............###.................................###...###
###...###.........###...###...........................###.................................###...###
###...###.........###...#################################.................................###...###
###...###.........###.....................###.........###.................................###...###
###...###.........###.....................###...#########.................................###...###
###...###.........###.....................###.............................................###...###
###...###.........###.....................###...###################################################
###...###.........###...........................###.............................................###
###...###.........###.....................###...###...............###...........................###
###...###...#########.....................###...#########...###...###...........................###
###...###.........###.....................###...###.........###...###...........................###
###...###.........###.....................###...###.........###...###...........................###
###...#########...###.....................###...###.........###...###...........................###
###...###...###...###.....................###...###.........###...###...........................###
###...###...###...###.....................###...###.........###...###...........................###
###...###.........###.....................###...###.........###...###...........................###
###...#######################################...###############...###...........................###
###.........###...........................###...###...............###...........................###
###.........###...............###...###...###...###...###...#########...........................###
###########################...###...###...###...###...###...###.................................###
###.....................###...###...###...###...###...###...###.................................###
###.....................###...###...###...###...#########...###...###########################...###
###.........###.........###...###...###...###...............###.........###.....................###
###############.........###...###...###...#####################...###...###...............###...###
###.....................###...###.................................###...###...............###...###
###...###...###############...###############...............###...#########...............###...###
###...###...................................................###...........................###...###
###################################################################################################
