+++++++++++++++++++++++++++++++++++++++++++++++++[]+++++++++++++++++++++++++++++++++++++++++++++++++
+..................................+.............H..............+..................................+
+..................................+............................+..................................+
+..................................+............................+..................................+
+..................................+............................+..................................+
+..................................+............................+..................................+
+..................................+............................+..................................+
+..................................+............................+..................................+
+..................................+............................+..................................+
+..................................+............................+..................................+
+..................................+............................+..................................+
+..................................+............................+..................................+
+..................................................................................................+
+..................................................................................................+
+..................................................................................................+
+..................................................................................................+
+..................................................................................................+
+C................................................................................................C+
+..................................................................................................+
+..................................................................................................+
+..................................................................................................+
+..................................................................................................+
+..................................................................................................+
+..................................................................................................+
+..................................+............................+..................................+
+..................................+............................+..................................+
+..................................+............................+..................................+
+..................................+............................+..................................+
+..................................+............................+..................................+
+..................................+............................+..................................+
+..................................+............................+..................................+
+..................................+............................+..................................+
+..................................+............................+..................................+
+..................................+............................+..................................+
+..................................+............................+..................................+
++++++++++++++++++++++++++++++++++++............................++++++++++++++++++++++++++++++++++++
+..................................................................................................+
+..................................................................................................+
+..................................................................................................+
+..................................................................................................+
+..................................................................................................+
+..................................................................................................+
+..................................................................................................+
+..................................................................................................+
+..................................................................................................+
+..................................................................................................+
+..................................................................................................+
+..................................................................................................+
+................................................?.................................................+
++++++++++++++++++++++++++++++++++++++++++++++++++++++++++++++++++++++++++++++++++++++++++++++++++++
